11111111111
10000100001
10110101101
10100000101
10101110101
10000000001
10101110101
10100000101
10110101101
10000100001
11111111111