1111111111111111111111111111111111111111
1000000000000100000000000011111111111111
1011110111110101111101111011111111111111
1000010000010101000001000011111111111111
1011110111110101111101111011111111111111
1000000000000000000000000011111111111111
1011110101111111110101111011111111111111
1000000100000100000100000011111111111111
1111110100000100000101111111111111111111
*****10100000100000101*****1111111111111
1111110100000100000101111111111111111111
1111110100000100000101111111111111111111
*****10100000100000101*****1111111111111
1111110100000100000101111111111111111111
1111110100000100000101111111111111111111
*****10100000100000101*****1111111111111
1111110100000100000101111111111111111111
1111110100000100000101111111111111111111
*****10100000100000101*****1111111111111
1111110100000100000101111111111111111111
1111110100000100000101111111111111111111
*****10100000100000101*****1111111111111
1111110100000100000101111111111111111111
1111110100000100000101111111111111111111
*****10100000100000101*****1111111111111
1111110100000100000101111111111111111111
1111111111111111111111111111111111111111
1111111111111111111111111111111111111111
1111111111111111111111111111111111111111
1111111111111111111111111111111111111111