1111111111111111111111111111111111111111
1*101000010000000001000010101000001000*1
1010001111110111110100100010000100111101
1000000000000100000100101000100100100001
1111101001010101001110001110100000101001
1000001001010000011*11001000101100001001
1111011101011110110001101110100110111001
1000000001000000000000000000100000000001
1111011001111111111011111111100111101101
1000001100010000000010000000000000101001
1111111001010101110111101011110010101101
1000001011110100000000001010000111100101
1101010010000110111011111011110000001101
1101110111110100000000000001000110000001
10000001010000001####1001101111010111111
1011100101011110111111001000100010010001
1010000000000000000000000000000000000101
1010111001111011101110111001110010010101
10101000010*1001000100100001000010010101
1010110101011001010100110101011011110101
1010100001000001000100100001000010010101
1010111101011011100100111101111010010101
1010000000010000000000000000000000000101
1011101111111011011111101111001011011101
1000001001*10010000100000001111000000001
1011111101000010111111110100000011111101
1000000001111110000000010111011110000001
1011111100000010111101110100000011111101
1*000000011110000000000000011110000000*1
1111111111111111111111111111111111111111